27 102
000000000000000000000000000000000000011111111111111111111111110000000000011111111100000000011111110000
000000000000000000000000000000000000001111111111111111111111111000000000111111111110000000001111111000
000000000000000000000000000000000000000111111111111111111111000000000011111111111111000000000111110000
000000000000000000000000000000000000000011111111111111111111100000000111111111111111100000000000000000
000000000000000000000000000000000000000000011111111111111000000000001111111111111111100000000000000000
000000000000000000000000000000000000011100000111111110100000000000011111111111111111110000000000000000
000000000000000000000111110000000001111110000000111100000000000000001111111111111111111000000000000000
000000000000000000001111111000000011111110000000001000000000000000000111111111111111111100000000000000
111000000000000000111111111100000011111110000000000000000000000000000011111111111111100000000000000000
111111100000000011111111111110000001111110000000000000000000000000000000000000000000000000000000000000
111111111100000011111111111110000000000000000000000000000000000000000000000000000000000000000000000000
111111111000000000111111111000000000000000000000000000000000000000000000000000000000000000000000000000
111111100000000000001111110000000000000000000000000000000000000000000000000000000000000000000000000000
111111100000000000000111100000000000000000000000000000000000000000000000000000000000000000000000000000
111111000000000000000000000000000000000000000000000000000000000000000000000000000000000000000000000000
111100000000000000000000000000000000000000000000000000000000000000000000000000000000000000000000000000
100000000000000000000000000000000000000000000000000000000000000000000000000000000000000000000000000000
000000000000000000000000000000000000111111111000000000000000000000000000000000000000000000000000000011
000000000000000000000000000000111111111111111111000000011000000000011000000000000001000000000000000111
000000000000010000000000000011111111111111111111111111111110000111111111100000001111111111000000111111
000000000001010100000000101111111111111111111111111111111111111111111111111111111111111111111111111111
000000001101010111111100111111111111111111111111111111111111111111111111111111111111111111111111111111
000000101111111111111111111111111111111111111111111111111111111111111111111111111111111111111111111111
000011111111111111111111111111111111111111111111111111111111111111111111111111111111111111111111111111
111111111111111111111111111111111111111111111111111111111111111111111111111111111111111111111111111111
111111111111111111111111111111111111111111111111111111111111111111111111111111111111111111111111111111
111111111111111111111111111111111111111111111111111111111111111111111111111111111111111111111111111111